# # # # # # # # # # # #
# . . . . # . . . . . # 
# . # . . . # . . . . #
# # . # . # . . . . . #
# . . . . . . . . . . #
# . # . . P . . . . . #
# . . . . . . . . . . #
# . . . . . . . . . . #
# . . . . . . . . . . #
# . . . # . . . . . . #
# . . . . . . . . . . #
# # # # # # # # # # # # 
