# # # # # # # #
# . . . . # . #
# . # . . . # # 
# # . # . # . # 
# . . . . . . # 
# . # . . P . # 
# . . . . . . # 
# # # # # # # # 
