# # # # # # # # # # # # # # # # # # # # # # # 
# . . . . . . . . . . . . . . . . . . . . . # 
# . . . . . . . . . . . . . . . . . . . . . # 
# . . . . . . . . . . . . . . . . . . . . . # 
# . . # . . # . . . . . . . . . . . . . . . #
# . . # . . # . . . . . . . . . . . . . . . #
# . . # . . # . . . . . . . . . . . . . . . #
# . . # . . # . . . . . . . . . . . . . . . #
# . . . . . . . . . . . . . . . . . . . . . #
# . . . . . . . . . . . . . . . . . . . . . #
# . . . . . . . . . . . . . . . . . . . . . #
# . . . . . . P . . . . . . . . . . . . . . #
# . . . . . . . . . . . . . . . . . . . . . #
# . . . . . . . . . . . . . . . . . . . . . #
# . . . . . . . . # # # # # # # # . . . . . #
# . . . . . . . . . . . . . . . . . . . . . #
# . . . . . . . . . . . . . . . . . . . . . #
# . . . . . . . . # # # # # # # . . . . . . #
# . . . . . . . . . . . . . . . . . . . . . #
# . . . . . . . . . . . . . . . . . . . . . #
# . . . . . . . . . . . . . . . . . . . . . #
# . . . . . . . . . . . . . . . . . . . . . #
# # # # # # # # # # # # # # # # # # # # # # #
