# # # # # # # # # # # # 
# . . . . . . . . . . # 
# . . . . . . . . . . # 
# . . . . . . . . . . # 
# . . . . . . . . . . # 
# . . . P . . . . . . # 
# . . . . . . . . . . # 
# . . . . . . . . . . # 
# . . . # # # . . . . # 
# . . . # # # . . . . # 
# # # # # # # # # # # # 
