# # # # # # # # #
# . . . . . . . #
# . . . . . . . #
# . . . . . . . #
# . . . . . . . #
# . . . P . . . #
# . . . . . . . #
# # # # # # # # # 
