# # # # # # # # # # # # # # # # # # # # # # # # # # # # #
# . . . . . . . . . . . . . # . . . . . . . . . . . . . #
# . . . . . . . . . . . . . # . . . . . . . . . . . . . #
# . . # # # . . # # # # . . # . . # # # # . . # # # . . #
# . . # # # . . # # # # . . # . . # # # # . . # # # . . #
# . . # # # . . # # # # . . # . . # # # # . . # # # . . #
# . . . . . . . . . . . . . . . . . . . . . . . . . . . #
# . . . . . . . . . . . . . P . . . . . . . . . . . . . #
# . . # # # . . # # . . # # # # # . . # # . . # # # . . #
# . . . . . . . # # . . . # # # . . . # # . . . . . . . #
# . . . . . . . # # . . . . # . . . . # # . . . . . . . #
# # # # # # . . # # # # . . # . . # # # # . . # # # # # #
# . . . . # . . # # # # . . . . . # # # # . . # . . . . #
# . . . . # . . # # . . . . . . . . . # # . . # . . . . #
# . . . . # . . # # . . . . . . . . . # # . . # . . . . #
# # # # # # . . # # . . . . . . . . . # # . . # # # # # #
# . . . . . . . . . . . . . . . . . . . . . . . . . . . #
# . . . . . . . . . . . . . . . . . . . . . . . . . . . #
# . . . . . . . . . . . . . . . . . . . . . . . . . . . #
# . . . . . . . . . . . . . . . . . . . . . . . . . . . #
# . . . . . . . . . . . . . . . . . . . . . . . . . . . #
# . . . . . . . . . . . . . . . . . . . . . . . . . . . #
# . . . . . . . . . . . . . . . . . . . . . . . . . . . #
# . . . . . . . . . . . . . . . . . . . . . . . . . . . #
# . . . . . . . . . . . . . . . . . . . . . . . . . . . #
# . . . . . . . . . . . . . . . . . . . . . . . . . . . #
# # # # # # # # # # # # # # # # # # # # # # # # # # # # # 
